PS => XPAE
HK => BAEP, BAIP, BASE, CFHK, CGMH, CLHK, CSHK, DBHK, EOTC, GSAL, GSXH, HSXA, JPMI, MAQH, SHSC, SIGH, SZSC, TFSD, TOCP, TRAS, TWHK, UBSX, XCGS, XGEM, XHKF, XHKG, XIHK, XPST
PT => ALXL, BFPT, ENXL, MFOX, OMIC, OMIP, OPEX, WQXL, XLIS
HN => XBCV
PY => XVPA
HR => XCRO, XTRZ, XZAG, XZAM, XZAP, ZAPA
HU => BETA, CIBH, CONC, EBHU, ERST, HUDX, HUPX, KCCP, KELR, KHHU, OTPB, RBHU, UCHU, XBND, XBUD, XGAS, XTND
QA => DSMD
ID => ICDX, XBBJ, XIDX, XJNB
IE => AREX, BBIE, BBIS, BKDM, BMLX, BMSI, CEPL, CSGI, DAVY, EQIE, EUCC, FXFM, FXRQ, HREU, ICUR, ICXR, IFXA, IFXC, IFXR, ITGL, LEUE, LEUF, MAQE, MCID, MSEL, RMTF, SEMX, SISI, TDGF, VFIL, VFSI, VFXO, XATL, XCDE, XDUB, XEBI, XESM, XEYE, XMSM, XPAC, XPAL, XPOL, XPOS, XRFQ
IL => XTAE
AE => DGCX, DIFX, DUMX, GMGD, IFAD, XADS, XDFM
IN => ACEX, ASTR, BSME, CDSL, FXCL, FXSW, ICXL, IINX, INSE, ISEX, MCXX, NBOT, NMCE, OTCX, PXIL, XBAN, XBOM, XCAL, XDES, XIMC, XMDS, XNCD, XNSE, XUSE
ZA => 4AXE, A2XX, ALTX, JSEB, XBES, XJSE, XSAF, XSFA, YLDX, ZARX, ZFXM
IQ => XIQS
IR => IFBX, IMEX, XTEH
IS => DICE, DNIS, FNIS, MICE, MNIS, XICE
IT => AKIS, ATFX, BEIS, BNLD, BREA, CGCM, CGDB, CGEB, CGGD, CGIT, CGND, CGQD, CGQT, CGTR, CREM, DDTX, EBMX, EMDR, EMIB, EMID, EMIR, ETFP, ETLX, FBSI, HMOD, HMTF, HRFQ, IBEQ, IBIS, IMMH, ISBA, ISBV, MCAD, MIVX, MOTX, MTAA, MTAH, MTSC, MTSO, MUBM, SEDX, SSOB, UBIM, UBIS, UCIT, XAIM, XDMI, XGME, XMIL, XMOT
AL => XALS, XTIR
AM => XARM
AO => XBDV
AR => BACE, BCFS, MVCX, ROFX, XBCC, XBCM, XBCX, XBUE, XCNF, XMAB, XMEV, XMTB, XMVL, XROS, XROX, XTUC
ZM => XLUS
AT => APAW, BKSK, EGSI, EXAA, OBKL, RBIV, RLBO, SLHB, UCBA, WBAH, WBDM, XRCB, XVIE, XWBO
AU => APXL, ASXB, ASXC, ASXP, ASXT, ASXV, AWBX, AWEX, BLEV, BLXA, CFAU, CGMA, CHIA, CLAU, CSAU, CXAC, CXAF, CXAM, CXAN, CXAP, CXAQ, CXAR, CXAV, CXAW, MACB, MAQX, MSAL, NSXB, SIGA, SIMV, XASX, XFEX, XNEC, XSFE, XYIE
AZ => BSEX, XIBE
ZW => XZIM
RO => BRDE, BRDL, BRDS, XBRM, XBSD, XBSE, XCAN, XRAS, XRPM
BA => BLBF, XBLB, XSSE
ZZ => BILT, XOFF, XXXX
BB => BAJM, XBAB
RS => XBEL
BD => XCHG, XDHA
RU => MISX, NAMX, RPDX, RTSX, RUSX, SPIM, XMOS, XPET, XPIC, XRUS, XSAM, XSIB
JM => XJAM
BE => ALXB, BEAM, BELB, BELF, BKBF, BKBR, BLPX, BMTS, BNPF, KBCB, MLXB, MTSD, MTSF, SMBB, TNLB, TNLK, VPXB, XBRD, XBRU
RW => ROTC, RSEX
JO => XAMM
BG => ABUL, GBUL, IBEX, IBUL, JBUL, MBUL, PBUL, XBUL, ZBUL
JP => BAJD, BASX, BETP, CFJP, CHIJ, CHIS, CHIV, CITD, CITX, CLJP, CMET, CSJP, DRCT, KAIX, LXJP, MAQJ, MIZX, MSMS, NMRJ, NMSX, NXJP, NXSE, NXVW, SBIJ, SBIU, SBIV, SIGJ, TWJP, TWJT, UTSL, XFKA, XJAS, XJPX, XKAC, XNGO, XNKS, XOSE, XOSJ, XSAP, XSBI, XTAM, XTFF, XTK1, XTK2, XTK3, XTKS, XTKT
BH => BFEX, XBAH
BM => 24EX, GTXE, XBDA
BO => XBOL
SA => XSAU
SC => TRPX
BR => BCMM, BOVM, BRIX, BVMF, CETI, SELC
SD => XKHA
BS => XBAA
SE => CASI, CRYD, CRYX, CSTO, DKED, DKFI, DNSE, DOSE, DSTO, EBON, ESTO, EUWB, FIED, FNSE, GBWB, GFKS, MNSE, MOSE, MSTO, NAPA, NMTF, NOCO, NOED, NOFI, NSME, ONSE, PNED, SEBS, SEED, SSME, SVES, SVEX, SWBI, USWB, XABC, XNDX, XNGM, XNMR, XOPV, XSAT, XSTO
SG => APCL, APEX, CLTD, ECAL, EEAL, IFSG, JADX, MASG, SMEX, SYFX, TFSA, TSIG, TWSG, XSBT, XSCA, XSCE, XSES, XSIM
BW => BOTE, BOTV, XBOT
SI => XLJM, XLJU, XSOP
BY => BCSE
SK => CBSK, EBRA, SPXE, XBRA
KE => XNAI
KG => XKSE
KH => XCSX
CA => BNSX, CAND, CANX, CHIC, COTC, IFCA, IVZX, LICA, LYNX, MATN, NEOC, NEOD, NEOE, NEON, NGXC, OMGA, PURE, RBCM, VDRK, XATS, XBBK, XCNQ, XCX2, XCXD, XDRK, XICX, XMOC, XMOD, XTNX, XTSE, XTSX
KN => XECS
SV => XSVA
CH => CCMS, CSAG, CSOT, CSZH, DOTS, EBSC, EBSS, KMUX, OTXB, ROSR, S3FM, STOX, UBSC, UBSF, UBSG, VLEX, XBRN, XBTR, XICB, XQMH, XREP, XROT, XSCU, XSDX, XSEB, XSLS, XSTV, XSTX, XSWM, XSWX, XVTX, ZKBX
SY => XDSE
CI => XBRV
SZ => XSWA
KR => GSXK, XKCM, XKEM, XKFB, XKFE, XKON, XKOS, XKRX
CL => BOVA, XBCL, XSGO
CM => XDSX
CN => CCFX, CFBC, CSSX, GSXC, SGEX, XCFE, XDCE, XINE, XSEC, XSGE, XSHE, XSHG, XSSC, XZCE
KW => XKUW
CO => XBOG
KY => XCAY
KZ => AIXK, CCEX, ETSC, XKAZ
CR => XBNV
CV => XBVC
TH => AFET, BEEX, TFEX, XBKF, XBKK, XMAI
CW => DCSX
LA => XLAO
LB => XBEY
CY => ATHL, ATLN, BCSC, CFIF, GPBC, MKAP, RENC, SIBC, XCYO, XCYS, XECM
CZ => CELP, CESI, CSOB, FTFM, FTFS, KOME, RFBK, UBCZ, WOOD, XPRA, XPRM, XPXE, XRMO, XRMZ
TN => XTUN
LI => XLGT, XLLB, XVPB
TR => EXTR, XDSM, XEDA, XEID, XEQY, XFNO, XIST, XPMS
LK => XCOL
TT => XTRN
DE => 360T, AUTO, BAAD, BDEA, BERA, BERB, BERC, BGFI, BGFX, BGSI, BINV, BLBB, BLBS, BLEQ, BLIQ, BSFX, CATS, CBKA, CBKC, CBKD, CBKE, CBKF, CBKG, CDSI, CGEC, CGEE, CGET, CGMD, CSDA, DAPA, DBAG, DBES, DBOX, DEKA, DUSA, DUSB, DUSC, DUSD, DZBK, ECAG, EQTA, EQTB, EQTC, EQTD, EUWA, EUWX, FICX, FRAA, FRAB, FRAS, FRAU, FRAV, FRAW, GSBE, GSEI, HAMA, HAMB, HAML, HAMM, HAMN, HANA, HANB, HELA, HSBT, IKBS, JEFE, JESI, JPEU, LBBW, LBCW, LBWL, LBWS, LIGA, LSSI, MESI, MHBD, MHEU, MSEU, MUNA, MUNB, MUNC, MUND, NCME, NESI, NLBX, NORD, RBCG, SCAG, SMBD, SMFF, SPEX, SSBI, SSBM, SSWM, STUA, STUB, STUC, STUD, TGAT, TGSI, UBSI, UBSL, UCDE, VONT, VTLS, VTPS, VWDA, VWDX, XBER, XDBC, XDBV, XDBX, XDEX, XDUS, XECB, XECC, XEEE, XEEO, XEER, XEHQ, XEQT, XERE, XERT, XETA, XETB, XETR, XETS, XETU, XETV, XETW, XEUM, XEUP, XEUR, XFRA, XGAT, XGRM, XHAM, XHAN, XINV, XMUN, XQTX, XSC1, XSC2, XSC3, XSCO, XSTF, XSTU, XXSC, ZOBX
TW => CFTW, GSXT, ROCO, XTAF, XTAI
TZ => XDAR
DK => ABSI, ALSI, DASI, DCSE, DKTC, DNDK, DSME, FNDK, JBSI, JYSI, LASP, MCSE, MNDK, NPGA, NYSI, SBSI, SKSI, SNSI, XCSE
LT => BAPX, FNLT, GETB, LMNR, SWLT, XLIT
LU => BCEE, BILU, BLUX, CCLX, DBLX, DHLX, EMTF, KBLC, KBLL, KBLS, KBLT, RBCB, RBSI, XLUX, XVES
LV => FNLV, SWLV, XRIS
DO => XBVR
UA => EESE, PFTQ, PFTS, SEPE, UICE, UKEX, XDFB, XKHR, XKIE, XKIS, XNDU, XODE, XPRI, XUAX, XUKR
LY => XLSM
UG => ULTX, XUGA
MA => XCAS
DZ => XALG
MD => XMOL
ME => XMNX
MG => XMDG
US => AATS, ACKF, ADVT, ALDP, AMXO, AQUA, ARCD, ARCO, ARCX, ARKX, ATDF, BAML, BAMX, BARD, BARL, BARX, BATO, BATS, BATY, BBSF, BCDX, BGCD, BGCF, BHSF, BIDS, BLKX, BLTD, BLUE, BNDD, BNYC, BOSD, BPOL, BTEC, BTNL, BVUS, BYXD, BZXD, C2OX, CAES, CAVE, CBLC, CBSX, CBTS, CDED, CECS, CGMI, CICX, CIOI, CMES, CMSF, CODA, CORE, CPGX, CRED, CSLP, CURX, DASH, DBAB, DBSX, DEAL, DWFI, DWSF, EDDP, EDGA, EDGD, EDGO, EDGX, EGMT, EMLD, ERIS, EXPM, FAST, FCBT, FCME, FICO, FINC, FINN, FINO, FINR, FINY, FNCS, FSEF, FTUS, FXAL, FXCM, G1XX, GLBX, GLLC, GLMX, GLPS, GLPX, GMNI, GOTC, GOVX, GREE, GSCO, GSEF, GTCO, GTSX, GTXS, HEGX, HPPO, HRTF, HRTX, HSFX, IATS, ICBX, ICEL, ICES, ICRO, ICSU, IEPA, IEXD, IEXG, IFED, IFUS, IMAG, IMBD, IMCC, IMCG, IMCR, IMCS, IMEN, IMFX, IMIR, INCA, INCR, ISDA, ITGI, JEFX, JLQD, JPBX, JPMS, JPMX, JSES, JSJX, KNCM, KNEM, KNIG, KNLI, LAMP, LASF, LEDG, LEVL, LIFI, LIUH, LIUS, LMNX, LQED, LQFI, LTAA, MAGM, MCRY, MELO, MIHI, MKAA, MLCO, MLVX, MOCX, MPRL, MSCO, MSPL, MSRP, MSTX, MTSB, MTUS, MTXA, MTXC, MTXM, MTXS, MTXX, NASD, NBLX, NFSA, NFSC, NFSD, NLAX, NMRA, NODX, NXUS, NYFX, NYMS, NYPC, NYSD, OLLC, OOTC, OPRA, OTCB, OTCM, OTCN, OTCQ, PINC, PINI, PINL, PINX, PIPE, PRSE, PSGM, PUMA, PUMX, RCMA, RICD, RICX, SAGE, SCXA, SCXF, SCXM, SCXO, SCXS, SGAS, SGMA, SGMT, SHAD, SHAW, SMFE, SOHO, SSTX, SUNT, TERA, TFSU, THEM, THRE, TMID, TPSE, TRCK, TRCX, TRU1, TRU2, TRUX, TRWB, TSAD, TSBX, TSEF, TWSF, UBSA, UBSP, UBSS, VABD, VALX, VCRS, VERT, VFCM, VFMI, VIRT, VTEX, VUSA, WEED, WELS, WSAG, XADF, XAQS, XASE, XBOS, XBOX, XBRT, XBXO, XCBF, XCBO, XCBT, XCEC, XCFF, XCHI, XCIS, XCME, XCUR, XELX, XFCI, XFDA, XGMX, XIMM, XINS, XIOM, XISA, XISE, XISX, XKBT, XMER, XMGE, XMIO, XNAS, XNCM, XNDQ, XNFI, XNGS, XNIM, XNLI, XNMS, XNYE, XNYL, XNYM, XNYS, XOCH, XOTC, XPBT, XPHL, XPHO, XPOR, XPSX, XPUS, XSEF, XSTM, XTRD, XWEE, YKNA, ZERO
MK => XMAE
EC => XGUA, XQUI
EE => FNEE, SWEE, XTAL
MN => XULA
EG => NILX, XCAI
UY => BVUR, UFEX, XMNT
UZ => XCET, XCUE, XKCE, XSTE, XUNI
MT => COMG, IFSM, PROS, XMAL
MU => GBOT, XAFX, XMAU
MV => MALX
MW => XMSW
MX => BIVA, CGMX, XEMD, XMEX
MY => MESQ, XKLS, XLFX, XRBM
VC => SVXI
MZ => XBVM
ES => ABAN, AGBP, ALLT, BBVA, BCMA, BMCL, BMEA, BMEX, CABK, CAPI, CIMB, CIMD, CIME, CIMV, CSMD, DOWE, DOWM, IBER, IBGH, MABX, MARF, MDRV, MERF, MIBG, OMEL, PAVE, SANT, SBAR, SBIL, SEND, SIMD, TOMG, TPES, XBAR, XBIL, XDPA, XDRF, XLAT, XMAD, XMFX, XMPW, XMRV, XNAF, XVAL
VE => BVCA
NA => XNAM
VN => HSTC, XHNF, XHNX, XSTC
NG => NASX, XNSA
NI => XMAN
NL => ABNA, AFSA, AFSI, AFSL, AFSO, AFSX, BAPE, BARU, BEUO, BEUP, BEUT, BTAM, BTFE, BTQE, CABV, CAPA, CAVD, CCRM, CCXE, CEUD, CEUO, CEUX, CLMX, COMM, CPTX, EBSD, EBSF, EBSI, EBSN, ECEU, ETPA, FLTR, FLWX, HCHC, IEBS, IMCO, IMCT, IMEQ, INGB, INGE, INGF, ISWN, ISWO, ISWP, ISWT, JLEU, LISZ, MANL, MHBE, MUBE, MUSN, NDEX, NDXS, NEXY, NIBC, NLPX, NPEX, NWNV, OHVO, RABO, RESE, RESF, TNLA, TOWR, TQEA, TQEB, TQEM, TQEX, TRNL, TWEA, TWEM, TWEO, TWEU, XAMS, XEMS, XEUC, XEUE, XEUI, XNXC, XNXD
VU => GXMA, POTC
NO => BULK, CNSI, ELEU, ELNO, ELSE, ELUK, FISH, FREI, FSHX, MERD, MERK, NEXO, NIBR, NOPS, NORX, NOSC, NOTC, OAPA, OSLC, SB1M, SPTR, STEE, XABG, XDNB, XIMA, XOAA, XOAD, XOAM, XOAS, XOSA, XOSC, XOSD, XOSL
NP => XNEP
FI => AXSI, DHEL, DNFI, FGEX, FNFI, FSME, MHEL, MNFI, OPCO, XHEL, XNOR
FJ => XSPS
FO => VMFX
NZ => NZFX, XNZE
FR => AACA, ALXP, AQEA, AQEU, AURB, AURO, BNPA, BNPS, BPSX, CMCI, COAL, EDRF, ELXE, EPEX, EXSB, EXSD, EXSE, EXSF, EXSH, EXSP, EXSY, EXYY, FMTS, GFPO, GIPB, GMEO, GMES, GMTF, GSPX, HBFR, HPCO, HPCS, HPCV, HPCX, ICOT, KOTF, LCHC, MHBP, MKTF, MLER, MLES, MLEX, MSAX, MSCX, MSNT, MTCH, MUBP, NATX, NOWX, ODDO, ODOC, SGOE, SMBP, TDON, TPEU, TPIC, TPIO, TPIR, TRXE, TSAF, XAFR, XAPA, XBLK, XBLN, XETF, XMAT, XMLI, XMON, XPAR, XPOT, XPOW, XPSF, XSGA, XSPM, XTXE
GB => 3579, AFDL, AIMX, AMPX, ANLP, ANTS, ANZL, AQXA, AQXE, ARAX, ARCH, ARIA, ATLB, AUTB, AUTP, AUTX, BALT, BANA, BAPA, BARK, BARO, BART, BASI, BATD, BATE, BATF, BATP, BBSI, BBSX, BCRM, BCSI, BCSL, BCXE, BETX, BGCB, BGCI, BGCO, BGFU, BGUK, BISI, BKLF, BKLN, BLNK, BLOX, BLTX, BMCM, BMLB, BMTF, BNTW, BOAL, BOAT, BOFS, BOSC, BOTC, BPLC, BRFQ, BRGA, BRNX, BTEE, BTLX, BTQG, BVUK, CBAL, CBNL, CCEU, CCML, CCO2, CEPU, CGMC, CGME, CGMG, CGML, CGMT, CHEV, CHID, CHIO, CHIX, CIBC, CIBP, CLVE, CMEC, CMEE, CMMT, CRYP, CSBX, CSCF, CSEC, CSEU, CSIN, CSLB, CSSI, CXOT, CXRT, DAIW, DBCR, DBCX, DBDC, DBIX, DBLN, DBMO, DBSE, DOWG, DVFX, EBSM, ECHO, ECSL, EIXE, ELIX, EMBX, ENCL, ENSY, EQLD, EXBO, EXCP, EXDC, EXEU, EXLP, EXMP, EXOR, EXOT, EXSI, EXVP, FAIR, FISU, FNUK, FRTE, FXGB, FXOP, GEMX, GFBM, GFBO, GFIB, GFIC, GFIF, GFIN, GFIR, GFSM, GFSO, GMEG, GMGL, GRIF, GRIO, GRSE, GSBX, GSIB, GSIL, GSSI, HRSI, HSBC, IBAL, ICEO, ICPM, IECL, IFEN, IFEU, IFLL, IFLO, IFLS, IFLX, IFUT, IGDL, IMCE, IMED, IMET, IMFD, IMGB, IMGI, IMMM, IMRD, IMSB, IMTF, INVE, IOCD, IOED, IOFI, IOFX, IOGB, IOGI, IOIR, IOMM, IOTC, IOTF, IPSX, IPXP, IPXW, ISSI, ISWA, ISWB, ISWC, ISWE, ISWR, ISWV, JEFS, JISI, JPCB, JPSI, JSSI, KBLM, KLEU, LBCM, LCUR, LIQF, LIQH, LIQU, LISX, LMAD, LMAE, LMAF, LMAO, LMAX, LMEC, LOTC, LOUI, LOYD, LPPM, MAEL, MAKX, MAQI, MAQL, MAQU, MCUR, MCXR, MCXS, METZ, MFGL, MFXA, MFXC, MFXR, MHBL, MHIP, MLIX, MLRQ, MLSI, MSIP, MSSI, MUBL, MUFP, MUSE, MUTI, MYTR, N2EX, NABA, NABE, NABL, NABU, NCML, NDCM, NEXD, NEXF, NEXG, NEXL, NEXN, NEXS, NEXT, NEXX, NOFF, NOSI, NWMS, NXEU, OCSI, OTCE, PARX, PEEL, PFXD, PIEU, PIRM, PLDX, PPEX, PVMF, QWIX, R5FX, RBCC, RBCE, RBCT, RBSX, REST, RTSI, RTSL, SBEX, SCOT, SECF, SFCL, SGMX, SGMY, SHAR, SICS, SMBE, SMBG, SNUK, SPDX, SPEC, SPRZ, SQUA, SSBT, SSEX, SSFX, SSIL, STAN, STFL, SUNB, SUNO, SWAP, TCDS, TCML, TDBL, TECO, TEFD, TEFX, TEGB, TEGI, TEIR, TEMB, TEMF, TEMI, TEMM, TEMR, TERE, TIRD, TNLL, TPEL, TPEO, TPIE, TPSL, TPSO, TRAL, TRAX, TRDE, TRDX, TREA, TREO, TREU, TRFW, TRQA, TRQB, TRQC, TRQM, TRQS, TRQX, TRSI, TSCB, TSCD, TSED, TSFI, TSGB, TSGI, TSMM, TSMR, TSRE, TWGP, UBIN, UBSB, UBSY, UKGD, UKPX, VAGL, VAGM, VCMO, VEGA, VFUK, VTBC, WELN, WINS, WINX, WSIL, WSIN, XALT, XCOR, XGCL, XGCX, XGDX, XGSX, XIEL, XLBM, XLCH, XLDN, XLDX, XLME, XLOD, XLOM, XLON, XMTS, XPHX, XPUK, XRSP, XSGB, XSMP, XSWB, XTXM, XUBS, XUMP
OM => XMUS
GE => XGSE
GG => XCIE
GH => XGHA
GI => GSXL
GR => AAPA, ABFI, ASEX, ENAX, ERBX, HDAT, HEMO, HOTC, PBGR, XADE, XATH, XIPO
GT => XGTG
PA => XPTY
GY => GSCI
PE => XLIM
PG => XPOM
PH => CLPH, PDEX, XPHS
PK => NCEL, XKAR
PL => BHWA, BNPP, BOSP, BPKO, HBPL, INGW, MBPL, PKOP, PLPD, PLPX, PTPG, RPWC, SIAB, TBSP, WBCL, WBKP, WBON, WDER, WETP, WGAS, WIND, WIPO, WMTF, XNCO, XWAR
